########
#S...###
##.#...#
##.##.##
#..#.###
##...###
##.#...#
##...###
##.#...#
##.##.##
#..#.###
##...#G#
##.#...#
########