#####################
################S####
##.................##
##.##################
##.............#...##
##.###.#####.#.#.#.##
##...#.#...#.#.#.#.##
##.#.#.###.#.#.#.#.##
##.#.#.....#.#...#.##
############G########
#####################